NO ./assets/grey_wall.xpm
SO ./assets/blue_wall.xpm
WE ./assets/purple_wall.xpm
EA ./assets/yellow_wall.xpm

C 255,220,255
F 220,100,0

        1111111111111111111111111
        1000000000110000000000001
        1011000001110000000000001
        1001000000000000000000001
111111111011000001110000000000001
100000000011000001110111111111111
11110111111111011100000010001
11110111111111011101010000X01
110000001101010111000000100X1
1000X00X0000000X0000000010X01
100X00000X00X0001101010010001
11000001110101011111011110N0111
11110111 1110101 101111010001
11111111 1111111 111111111111